#####################
#...................#
#...................#
#...................#
#.........K.........#
#........###........#
#.......#####.......#
#......#######......#
#.....#########.....#
#p...###########....#
#####################
