####1####2#####3#####
#..................##
#..................##
#..................##
#...#....#.....#...##
#...#....#.....#...P,
#..................##
#...............bb.##
#...............bb.##
#p..............bb.##
#####################
