#####....############
Ip..#....#e#ggggg.go#
###.#....#o#geeeg.ge#
..#g#....#o#ggggg.gg#
..#g######o..ooo....#
..#ggg.C..o..egg....#
###################P#
#.o..o..o..o..o..o#.#
#og.og.og.og.og.og#.#
,g.og.og.og.og.og.C.#
#####################
