#####################
#..................P,
#.###################
#.o...............C.#
#og......eeeee....#.#
###################.#
###gggo.e##########.#
###geg#.###########.#
#p.ggg#...C..ggg....#
#######.#############
#####################